AatII	GACGTC
Acc65I	GGTACC
AccI	GTMKAC
AciI	CCGC
AclI	AACGTT
AcuI	CTGAAG
AfeI	AGCGCT
AflII	CTTAAG
AflIII	ACRYGT
AgeI-HF®	ACCGGT
AhdI	GACNNNNNGTC
AleI-v2	CACNNNNGTG
AluI	AGCT
AlwI	GGATC
AlwNI	CAGNNNCTG
ApaI	GGGCCC
ApaLI	GTGCAC
ApeKI TseI	GCWGC
ApoI-HF	RAATTY
AscI	GGCGCGCC
AseI	ATTAAT
AsiSI	GCGATCGC
AvaI BsoBI	CYCGRG
AvaII	GGWCC
AvrII	CCTAGG
BaeGI	GKGCMC
BaeI	ACNNNNGTAYC
BamHI-HF® BamHI	GGATCC
BanI	GGYRCC
BanII	GRGCYC
BbsI BbsI-HF®	GAAGAC
BbvCI	CCTCAGC
BbvI	GCAGC
BccI	CCATC
BceAI	ACGGC
BcgI	CGANNNNNNTGC
BciVI	GTATCC
BclI-HF BclI	TGATCA
BfaI	CTAG
BfuAI BspMI	ACCTGC
BglI	GCCNNNNNGGC
BglII	AGATCT
BlpI	GCTNAGC
BmgBI	CACGTC
BmrI	ACTGGG
BmtI-HF®	GCTAGC
BpmI	CTGGAG
Bpu10I	CCTNAGC
BpuEI	CTTGAG
BsaAI	YACGTR
BsaBI	GATNNNNATC
BsaHI	GRCGYC
BsaI-HF®v2	GGTCTC
BsaJI	CCNNGG
BsaWI	WCCGGW
BsaXI	ACNNNNNCTCC
BseRI	GAGGAG
BseYI	CCCAGC
BsgI	GTGCAG
BsiEI	CGRYCG
BsiHKAI	GWGCWC
BsiWI-HF® BsiWI	CGTACG
BslI	CCNNNNNNNGG
BsmAI BcoDI	GTCTC
BsmBI-v2	CGTCTC
BsmFI	GGGAC
BsmI	GAATGC
Bsp1286I	GDGCHC
BspCNI	CTCAG
BspDI ClaI	ATCGAT
BspEI	TCCGGA
BspHI	TCATGA
BsrBI	CCGCTC
BsrDI	GCAATG
BsrFI-v2	RCCGGY
BsrGI-HF®	TGTACA
BsrI	ACTGG
BssHII	GCGCGC
BssSI-v2	CACGAG
BstAPI	GCANNNNNTGC
BstBI	TTCGAA
BstEII-HF®	GGTNACC
BstNI	CCWGG
BstUI	CGCG
BstXI	CCANNNNNNTGG
BstYI	RGATCY
BstZ17I-HF®	GTATAC
Bsu36I	CCTNAGG
BtgI	CCRYGG
BtgZI	GCGATG
BtsCI	GGATG
BtsI-v2	GCAGTG
BtsIMutI	CAGTG
Cac8I	GCNNGC
CspCI	CAANNNNNGTGG
CviKI-1	RGCY
CviQI	GTAC
DdeI	CTNAG
DpnI	GATC
DraI	TTTAAA
DraIII-HF®	CACNNNGTG
DrdI	GACNNNNNNGTC
EaeI	YGGCCR
EagI-HF®	CGGCCG
EarI	CTCTTC
EciI	GGCGGA
Eco53kI	GAGCTC
EcoNI	CCTNNNNNAGG
EcoO109I	RGGNCCY
EcoP15I	CAGCAG
EcoRI-HF® EcoRI	GAATTC
EcoRV-HF® EcoRV	GATATC
Esp3I	CGTCTC
FatI	CATG
FauI	CCCGC
Fnu4HI	GCNGC
FokI	GGATG
FseI	GGCCGGCC
FspI	TGCGCA
HaeII	RGCGCY
HaeIII	GGCC
HgaI	GACGC
HhaI	GCGC
HincII	GTYRAC
HindIII-HF® HindIII	AAGCTT
HinfI	GANTC
HinP1I	GCGC
HpaI	GTTAAC
HpaII MspI	CCGG
HphI	GGTGA
Hpy166II	GTNNAC
Hpy188I	TCNGA
Hpy188III	TCNNGA
Hpy99I	CGWCG
HpyAV	CCTTC
HpyCH4III	ACNGT
HpyCH4IV	ACGT
HpyCH4V	TGCA
I-CeuI	TAACTATAACGGTCCTAAGGTAGCGAA
I-SceI	TAGGGATAACAGGGTAAT
KasI	GGCGCC
KpnI-HF®	GGTACC
MboI Sau3AI DpnII	GATC
MboII	GAAGA
MfeI-HF®	CAATTG
MluCI	AATT
MluI-HF®	ACGCGT
MlyI	GAGTC
MmeI	TCCRAC
MnlI	CCTC
MscI	TGGCCA
MseI	TTAA
MslI	CAYNNNNRTG
MspA1I	CMGCKG
MspJI	CNNR
MwoI	GCNNNNNNNGC
NaeI	GCCGGC
NarI	GGCGCC
Nb.BbvCI	CCTCAGC
Nb.BsmI	GAATGC
Nb.BsrDI	GCAATG
Nb.BssSI	CACGAG
Nb.BtsI	GCAGTG
NciI	CCSGG
NcoI-HF® NcoI	CCATGG
NdeI	CATATG
NgoMIV	GCCGGC
NheI-HF®	GCTAGC
NlaIII	CATG
NlaIV	GGNNCC
NmeAIII	GCCGAG
NotI-HF® NotI	GCGGCCGC
NruI-HF®	TCGCGA
NsiI NsiI-HF®	ATGCAT
NspI	RCATGY
Nt.AlwI	GGATC
Nt.BbvCI	CCTCAGC
Nt.BsmAI	GTCTC
Nt.BspQI	GCTCTTC
Nt.CviPII	CCD
PacI	TTAATTAA
PaeR7I XhoI	CTCGAG
PaqCI	CACCTGC
PciI	ACATGT
PflFI Tth111I	GACNNNGTC
PflMI	CCANNNNNTGG
PI-PspI	TGGCAAACAGCTATTATGGGTATTATGGGT
PI-SceI	ATCTATGTCGGGTGCGGAGAAAGAGGTAAT
PleI	GAGTC
PluTI	GGCGCC
PmeI	GTTTAAAC
PmlI	CACGTG
PpuMI	RGGWCCY
PshAI	GACNNNNGTC
PsiI-v2	TTATAA
PspGI	CCWGG
PspOMI	GGGCCC
PspXI	VCTCGAGB
PstI-HF® PstI	CTGCAG
PvuI-HF®	CGATCG
PvuII-HF® PvuII	CAGCTG
RsaI	GTAC
RsrII	CGGWCCG
SacI-HF®	GAGCTC
SacII	CCGCGG
SalI-HF® SalI	GTCGAC
SapI BspQI-HF® BspQI	GCTCTTC
Sau96I	GGNCC
SbfI-HF®	CCTGCAGG
ScaI-HF®	AGTACT
ScrFI	CCNGG
SexAI	ACCWGGT
SfaNI	GCATC
SfcI	CTRYAG
SfiI	GGCCNNNNNGGCC
SfoI	GGCGCC
SgrAI	CRCCGGYG
SmaI	CCCGGG
SmlI	CTYRAG
SnaBI	TACGTA
SpeI-HF®	ACTAGT
SphI-HF® SphI	GCATGC
SrfI	GCCCGGGC
SspI-HF®	AATATT
StuI	AGGCCT
StyD4I	CCNGG
StyI-HF®	CCWWGG
SwaI	ATTTAAAT
TaqI-v2	TCGA
TfiI	GAWTC
Tsp45I	GTSAC
TspRI	NNCASTGNN
WarmStart® Nt.BstNBI Nt.BstNBI	GAGTC
XbaI	TCTAGA
XcmI	CCANNNNNNNNNTGG
XmaI TspMI	CCCGGG
XmnI	GAANNNNTTC
ZraI	GACGTC
